000000000000000000000000000000000000000000000000000000000000000000000000000000000000
000000000000000000000000000000000000000000000000000000000000000000000000000000000000
000000000000000000000000000000000000000000000000000000000000000000000000000000000000
000000000000000000000000000000000000000000000000000000000000000000000000000000000000
000000000000000000000000000000000000000000000000000000000000000000000000000000000000
000000000000000000000000000000000000000000000000000000000000000000000000000000000000
000000022222000000000000000000000000000000000000000000000000000000000000000000000000
000000000000000000000000000000000000000000000000000000000000000000000000000000000000
220000000000000002200000022000000000000000010000000000000000000000000000000000000000
112222222222222221100002211200000000000000010000000000000000000000000000000000000000
111111111111111111100001111100111111111111111111111111111111111111111111111111111111
111111111111111111100000110000111111111111111111111111111111111111111111111111111111
111111111111111111100000110000111111111111111111111111111111111111111111111111111111